%%%%%%%%%%%%%%%%%%%%%%%%%%%%%%%%%%%%%%
%                                   P%
% %%%%%%%%%%%%%%%%%%% %%%  %%%%%%%%  %
% %%   %   %      %%% %%%    %%G     %
% %% %G% % % %%%% %%%%%%%%%  %%  %%%%%
% %% % % % % %    %%G        %%      %
% %% % % % % % %%%%%  %%%    %%%%%%G %
% %% % % %   %    %%  %%%%%%%%%      % 
% %% % % %%%%%%%% %%         %%  %%%%%
% %% %   %%       %%%%%%%%%G %%      %
%    %%% %% %%%%%%%      %%  %%%%%%GG%
%%%%%%      %       %    %% G%%      %
%      %%%%%% %%G G%%    %%  %%  %%%%%
% %%%%%%      %       %%%%%G %%      %
%          %%%%       %%%%%  %%%%%%  %
%%%%%%%%G G%                 %%%%%%  %
%.         %%%%%%%%%%%%%%%%          %
%%%%%%%%%%%%%%%%%%%%%%%%%%%%%%%%%%%%%%
